WWWWWWWWWW
W  SHM F W
WWWWE    W
W   WW   W
W     WE W
WH    F FW
W  BketTWW
W  M  F  W
WK       W
WWWWWWDWWW
