WWWWWWWWWW
D GWFWWWMW
WGMW WE  W
W GW W W W
WG W W W W
W GW WkW W
WGGW W W W
WG W WKW W
W G t  W W
WWWWWWWWWW
