WWWWWWWWWW
WGGGSMGGGW
WGGGG GGGW
W       BW
W        W
WB       W
WH       W
WWWW     W
WM      sW
WWWWWWWWWW