WWWWWWWWWW
W        W
WWWWE    W
W   WW   W
W     WE W
WH       W
W  BketTWW
W  M     W
WK       W
WWOWWWWWoW
